ContextMenu_LookAtBlueprints = "查看蓝图",
ContextMenu_StartSketchingBlueprints = "开始绘制蓝图",
ContextMenu_TooDarkToDraw = "光线太暗，无法绘制。",
IGUI_Builders_Sketchbook = "建筑师速写本",
IGUI_Sketchbook_Chapter = "第%1章：%2",
IGUI_Sketchbook_Chapter_Appliances = "家电设备",
IGUI_Sketchbook_Chapter_Containers = "储物容器",
IGUI_Sketchbook_Chapter_Decorations = "装饰物品",
IGUI_Sketchbook_Chapter_Doors = "门具",
IGUI_Sketchbook_Chapter_Fences = "围栏",
IGUI_Sketchbook_Chapter_Floors = "地板",
IGUI_Sketchbook_Chapter_Furniture = "家具",
IGUI_Sketchbook_Chapter_Lighting = "照明设备",
IGUI_Sketchbook_Chapter_Masonry = "砖石结构",
IGUI_Sketchbook_Chapter_Stairs = "楼梯",
IGUI_Sketchbook_Chapter_Welding = "焊接制品",
IGUI_Sketchbook_Chapter_Windows = "窗户",
IGUI_Sketchbook_Chapter_Other = "其他",
IGUI_Sketchbook_Category_Appliances_Bathroom = "家电设备 - 卫浴",
IGUI_Sketchbook_Category_Appliances_Cooking = "家电设备 - 烹饪",
IGUI_Sketchbook_Category_Appliances_Fridges = "家电设备 - 冰箱",
IGUI_Sketchbook_Category_Appliances_Laundry = "家电设备 - 洗衣",
IGUI_Sketchbook_Category_Containers_Bookshelves = "储物容器 - 书架",
IGUI_Sketchbook_Category_Containers_Commercial = "储物容器 - 商用",
IGUI_Sketchbook_Category_Containers_Crates = "储物容器 - 木箱",
IGUI_Sketchbook_Category_Containers_Metal = "储物容器 - 金属制",
IGUI_Sketchbook_Category_Containers_Residential = "储物容器 - 家用",
IGUI_Sketchbook_Category_Containers_Trashcans = "储物容器 - 垃圾桶",
IGUI_Sketchbook_Category_Decorations_Garage = "装饰物品 - 车库",
IGUI_Sketchbook_Category_Decorations_Rugs = "装饰物品 - 地毯",
IGUI_Sketchbook_Category_Decorations_Roadway = "装饰物品 - 道路",
IGUI_Sketchbook_Category_Decorations_Outdoor = "装饰物品 - 户外",
IGUI_Sketchbook_Category_Doors_Garage = "门具 - 车库门",
IGUI_Sketchbook_Category_Doors_Metal = "门具 - 金属门",
IGUI_Sketchbook_Category_Doors_Wooden = "门具 - 木门",
IGUI_Sketchbook_Category_Fences_High = "围栏 - 高围栏",
IGUI_Sketchbook_Category_Fences_Low = "围栏 - 矮围栏",
IGUI_Sketchbook_Category_Floors_Carpets = "地板 - 地毯",
IGUI_Sketchbook_Category_Floors_Ceramic = "地板 - 陶瓷砖",
IGUI_Sketchbook_Category_Floors_Concrete = "地板 - 混凝土",
IGUI_Sketchbook_Category_Floors_Metal = "地板 - 金属",
IGUI_Sketchbook_Category_Floors_Natural = "地板 - 天然材质",
IGUI_Sketchbook_Category_Floors_Paved = "地板 - 铺装地面",
IGUI_Sketchbook_Category_Floors_Wooden = "地板 - 木质",
IGUI_Sketchbook_Category_Furniture_Beds = "家具 - 床具",
IGUI_Sketchbook_Category_Furniture_Dressers = "家具 - 抽屉柜",
IGUI_Sketchbook_Category_Furniture_Seating = "家具 - 座椅",
IGUI_Sketchbook_Category_Furniture_Tables = "家具 - 桌椅",
IGUI_Sketchbook_Category_Lighting = "照明设备",
IGUI_Sketchbook_Category_Masonry = "砖石结构",
IGUI_Sketchbook_Category_Stairs_Metal = "楼梯 - 金属楼梯",
IGUI_Sketchbook_Category_Stairs_Wood = "楼梯 - 木质楼梯",
IGUI_Sketchbook_Category_Welding = "焊接制品",
IGUI_Sketchbook_Category_Windows = "窗户",
IGUI_Sketchbook_Category_Other = "其他",
ItemName_Base.RefrigerantBottle = "制冷剂瓶",
ItemName_Base.RefrigeratorCompressor = "冰箱压缩机",
ItemName_Base.PlasticSheet = "塑料薄板",
ItemName_Base.PlasticSheetSmall = "小型塑料薄板",
ItemName_Base.InsulationFoam = "绝缘泡沫",
ItemName_Base.SmallRubberTube = "小型橡胶管",
ItemName_Base.ThinCopperPipe = "细铜管",
ItemName_Base.RubberSeal = "橡胶密封圈",
ItemName_Base.AsphaltMixturePowder = "袋装沥青混合粉",
ItemName_Base.BucketAsphaltMixtureFull = "桶装沥青混合物",
ItemName_Base.FineWoodWorking_Furniture_BedsCouchesArmchairs = "杂志：《精细木工》- 床具、沙发与扶手椅特辑",
ItemName_Base.FineWoodWorking_Furniture_ChairsBenches = "杂志：《精细木工》- 座椅与长椅特辑",
ItemName_Base.FineWoodWorking_Furniture_Dressers = "杂志：《精细木工》- 抽屉柜制作特辑",
ItemName_Base.FineWoodWorking_Furniture_Crates = "杂志：《精细木工》- 木箱制作特辑",
ItemName_Base.FineWoodWorking_Furniture_Counters = "杂志：《精细木工》- 柜台制作特辑",
ItemName_Base.FineWoodWorking_Furniture_DesksTables = "杂志：《精细木工》- 书桌与餐桌特辑",
ItemName_Base.FineWoodWorking_DoorsWindows = "杂志：《精细木工》- 门窗制作特辑",
ItemName_Base.TheFamilyHandyman_StairsFences = "杂志：《家庭杂工》- 楼梯与围栏特辑",
ItemName_Base.OldHouseJournal_WoodenFloors = "杂志：《老房日志》- 木质地板特辑",
ItemName_Base.ArchitecturalDigest_RugsCarpets = "杂志：《建筑文摘》- 地毯与地垫特辑",
ItemName_Base.HomeMechanix_Bathroom = "杂志：《家庭机械师》- 卫浴家电特辑",
ItemName_Base.ProjectsInMetal_Diverse = "杂志：《金属工艺项目集》",
ItemName_Base.PopularMechanics_Lighting = "杂志：《大众机械师》- 照明设备特辑",
ItemName_Base.PopularMechanics_HomeAppliances = "杂志：《大众机械师》- 家用家电特辑",
ItemName_Base.FlooringGuide_Ceramic = "杂志：《地板指南》- 陶瓷地砖特辑",
ItemName_Base.FlooringGuide_Paved = "杂志：《地板指南》- 铺装地面特辑",
ItemName_Base.DecorationsGuide_RoadwayGarage = "杂志：《装饰指南》- 道路与车库装饰特辑",
ItemName_Base.BuildersSketchbook = "建筑师速写本",
Recipe_MakeBucketAsphaltMixture = "制作桶装沥青混合物",
Recipe_MakeBuildersSketchbook = "制作建筑师速写本",
GlassDisplayStand = "玻璃展示架",
GlassDisplayCounterCorner = "玻璃展示柜转角",
TheaterCounterCorner = "影院柜台转角",
GenericShopCounterCorner = "通用商店柜台转角",
TheaterCounter = "影院柜台",
DinerCounter = " diner（ diner 指美式小餐馆）柜台",
LargeShopShelves = "大型商店货架",
BarBrownWallBar = "棕色墙面吧台",
SquareTheaterCounter = "方形影院柜台",
GroceryTrapezoidCounter = "杂货店梯形柜台",
Gas2GoCounter = "Gas2Go（加油站品牌）柜台",
WhiteStrippedDisplayStand = "白色条纹展示架",
ZippeeCounterCorner = "Zippee（店铺品牌）柜台转角",
SpiffosCounter = "Spiffo's（品牌）柜台",
GlassDisplayCounter = "玻璃展示柜",
BlackBarCounterCorner = "黑色吧台转角",
GenericShopCounter = "通用商店柜台",
LeftBarBrownWallBar = "左侧棕色墙面吧台",
FossoilCounter = "Fossoil（品牌）柜台",
TrapezoidShopShelves = "梯形商店货架",
ZippeeCounter = "Zippee（店铺品牌）柜台",
DinerCounterCorner = " diner 柜台转角",
BarBlackWallBar = "黑色墙面吧台",
FossoilCounterCorner = "Fossoil（品牌）柜台转角",
LeftBarBlackWallBar = "左侧黑色墙面吧台",
PizzaWhirledCounter = "Pizza Whirled（披萨店品牌）柜台",
OakBarCounterCorner = "橡木吧台转角",
Gas2GoCounterCorner = "Gas2Go（加油站品牌）柜台转角",
PizzaWhirledCounterCorner = "Pizza Whirled（披萨店品牌）柜台转角",
WhiteStrippedCounterCorner = "白色条纹柜台转角",
WhiteDisplayCounter = "白色展示柜",
RightBarBlackWallBar = "右侧黑色墙面吧台",
ShopDisplayCounter = "商店展示柜",
BlackBarCounter = "黑色吧台",
BrownBarCounterCorner = "棕色吧台转角",
WhiteStrippedCounter = "白色条纹柜台",
RoundedGlassDisplayCounter = "弧形玻璃展示柜",
BrownBarCounter = "棕色吧台",
RightBarBrownWallBar = "右侧棕色墙面吧台",
GroceryDisplayCounter = "杂货店展示柜",
SeahorseCoffeeCounterCorner = "海马咖啡店柜台转角",
OakBarCounter = "橡木吧台",
SeahorseCoffeeCounter = "海马咖啡店柜台",
SpiffosCounterCorner = "Spiffo's（品牌）柜台转角",
FloorGreyCarpet = "灰色地毯",
FloorYellowCarpet = "黄色地毯",
FloorBlueCarpet = "蓝色地毯",
FloorDarkRedCarpet = "深红色地毯",
FloorDarkGreyCarpet = "深灰色地毯",
FloorLightGreenCarpet = "浅绿色地毯",
FloorBrownCarpet = "棕色地毯",
FloorRedCarpet = "红色地毯",
FloorGreenCarpet = "绿色地毯",
FloorBeigeCarpet = "米色地毯",
FloorPurpleCarpet = "紫色地毯",
FloorWhiteCarpet = "白色地毯",
FloorGreenesGroceryCarpet = "Greenes 杂货店专用地毯",
FloorBlackCarpet = "黑色地毯",
FloorBordeauxCarpet = "波尔多红地毯",
FloorGreyCurlyCarpet = "灰色卷毛地毯",
FloorVioletCarpet = "紫罗兰色地毯",
Victorian1Armchair = "维多利亚风格1号扶手椅",
FancyOutdoorsBench = "精致户外长椅",
DarkWoodenChair = "深色木椅",
PurpleRattanArmchair = "紫色藤编扶手椅",
WhiteModernArmchair = "白色现代扶手椅",
TrailerFixedBench = "拖车固定长椅",
Victorian5Couch = "维多利亚风格5号沙发",
FancyWhiteArmchair = "精致白色扶手椅",
BlackOfficeChair = "黑色办公椅",
Victorian4Armchair = "维多利亚风格4号扶手椅",
PurpleRattanCouch = "紫色藤编沙发",
OrangeModernArmchair = "橙色现代扶手椅",
Victorian5Armchair = "维多利亚风格5号扶手椅",
GreyLazyCouch = "灰色懒人沙发",
OrangeModernCouch = "橙色现代沙发",
SpiffoLoungeSeat = "Spiffo's（品牌）休闲座椅",
YellowModernArmchair = "黄色现代扶手椅",
GreenDinnerChair = "绿色餐椅",
GreyChair = "灰色椅子",
BluePlasticChair = "蓝色塑料椅",
WoodenChair = "木质椅子",
RedModernArmchair = "红色现代扶手椅",
Victorian2Couch = "维多利亚风格2号沙发",
BrownLazyArmchair = "棕色懒人扶手椅",
YellowModernCouch = "黄色现代沙发",
BrownLazyCouch = "棕色懒人沙发",
PizzaWhirledSeat = "Pizza Whirled（披萨店品牌）座椅",
BrickWallBench = "砖墙长椅",
FoldingChair = "折叠椅",
Victorian6Armchair = "维多利亚风格6号扶手椅",
WhiteLazyCouch = "白色懒人沙发",
Victorian4Couch = "维多利亚风格4号沙发",
BlueRattanArmchair = "蓝色藤编扶手椅",
RedWoodenChair = "红色木椅",
BlackFancyArmchair = "精致黑色扶手椅",
GreyLazyArmchair = "灰色懒人扶手椅",
GreenComfyCouch = "绿色舒适沙发",
SturdyBench = "坚固长椅",
BlueRattanCouch = "蓝色藤编沙发",
GreenComfyArmchair = "绿色舒适扶手椅",
ParkBench = "公园长椅",
BlueComfyArmchair = "蓝色舒适扶手椅",
BlueSeat = "蓝色座椅",
ChurchPew = "教堂长椅",
Victorian2Armchair = "维多利亚风格2号扶手椅",
WhiteWoodenChair = "白色木椅",
50sSeat = "50年代风格座椅",
WhiteLazyArmchair = "白色懒人扶手椅",
Victorian6Couch = "维多利亚风格6号沙发",
Victorian3Couch = "维多利亚风格3号沙发",
Victorian3Armchair = "维多利亚风格3号扶手椅",
Victorian1Couch = "维多利亚风格1号沙发",
3TileRedWindowGarageDoor = "3格带窗红色车库门",
3TileGreenGarageDoor = "3格绿色车库门",
3TileWhiteGarageDoor = "3格白色车库门",
3TileRollingWindowGarageDoor = "3格带窗卷帘车库门",
3TileRollingGarageDoor = "3格卷帘车库门",
RedMobileToolCabinet = "红色移动式工具柜",
FireplaceDouble = "双开门壁炉",
Fireplace = "壁炉",
FancyOakDrawers = "精致橡木抽屉柜",
FancyDarkDrawers = "精致深色抽屉柜",
BedroomDrawers = "卧室抽屉柜",
MirrorAndDrawers = "带镜抽屉柜",
SmallTableWithDrawer = "带抽屉小桌子",
FancyDarkWardrobe = "精致深色衣柜",
LightWoodWardrobe = "浅色木质衣柜",
FancyWhiteDrawers = "精致白色抽屉柜",
FancyWhiteWardrobe = "精致白色衣柜",
LargeWardrobe = "大型衣柜",
FancyOakWardrobe = "精致橡木衣柜",
LightWoodDrawers = "浅色木质抽屉柜",
RoundOutdoorLamp = "圆形户外灯",
FancyOutdoorLamp = "精致户外灯",
OvalOutdoorLamp = "椭圆形户外灯",
FloodLights = "泛光灯",
LightSwitchRightSide = "右侧电灯开关",
TallLightPost = "高杆路灯",
AntiqueOutdoorLamp = "复古户外灯",
FancyGreyLightPost = "精致灰色灯杆",
ModernOutdoorLamp = "现代户外灯",
FancyLightPost = "精致灯杆",
NeonOpenSign = "霓虹“营业中”招牌",
OvalLightPost = "椭圆形灯杆",
LightSwitchLeftSide = "左侧电灯开关",
SeaHorseBrownWindowDoor = "海马牌棕色带窗门",
BlackPanelDoor = "黑色镶板门",
BrownWindowDoor = "棕色带窗门",
WoodenDoor = "木质门",
Gas2GoRedWindowDoor = "Gas2Go（加油站品牌）红色带窗门",
BrownDoor = "棕色门",
SinglePaneBlackDoor = "单玻璃黑色门",
SinglePaneChestnutDoor = "单玻璃栗色门",
WhiteGlassSlidingDoor = "白色玻璃推拉门",
TanDoor = "棕褐色门",
SpiffoOrangeWindowDoor = "Spiffo's（品牌）橙色带窗门",
BlueDoor = "蓝色门",
BrownGlassSlidingDoor = "棕色玻璃推拉门",
RoughWoodenDoor = "粗制木质门",
PileOCrepeBlueWindowDoor = "Pile O' Crepe（店铺品牌）蓝色带窗门",
WhitePanelDoor = "白色镶板门",
BlackDoor = "黑色门",
BrownPanelDoor = "棕色镶板门",
DoublePaneBlackDoor = "双玻璃黑色门",
WhiteWindowDoor = "白色带窗门",
FossoilBlueWindowDoor = "Fossoil（品牌）蓝色带窗门",
WhiteDoor = "白色门",
CherryDoor = "樱桃木门",
PizzaWhirledBrownWindowDoor = "Pizza Whirled（披萨店品牌）棕色带窗门",
LongDarkLowTable = "深色长条矮桌",
BleachedLargeTable = "漂白大型桌子",
LightRoundLargeTable = "浅色圆形大型桌子",
SmoothPlasticLargeTable = "光滑塑料大型桌子",
BrownLowTable = "棕色矮桌",
FancyLargeTable = "精致大型桌子",
FancyDarkLargeTable = "精致深色大型桌子",
SpiffoTypeBLargeTable = "Spiffo's（品牌）B型大型桌子",
BrownLargeTable = "棕色大型桌子",
DarkWoodenLargeTable = "深色木质大型桌子",
FancyLowTable = "精致矮桌",
LongLightLowTable = "浅色长条矮桌",
OakRoundLargeTable = "橡木圆形大型桌子",
LightLowTable = "浅色矮桌",
LightOakLargeTable = "浅色橡木大型桌子",
LongLowTable = "长条矮桌",
SmoothLargeTable = "光滑大型桌子",
PlasticLowTable = "塑料矮桌",
BlackModernLowTable = "黑色现代矮桌",
DarkLargeTable = "深色大型桌子",
BrownOfficeLargeDesk = "棕色办公大书桌",
LightWoodRestaurantLargeTable = "浅色木质餐厅大型桌子",
LightwoodLargeDesk = "浅色木质大书桌",
SpiffoTypeALargeTable = "Spiffo's（品牌）A型大型桌子",
OakLargeTable = "橡木大型桌子",
PlasticLargeTable = "塑料大型桌子",
BroadWhiteLargeTable = "宽面白色大型桌子",
SimpleLargeTable = "简易大型桌子",
LongLowDoubleTable = "双层长条矮桌",
OfficeLargeDesk = "办公大书桌",
DarkOakLargeTable = "深色橡木大型桌子",
TanMetalDoor = "棕褐色金属门",
DoubleMetalGreyLeftDoor = "灰色双开金属左门",
WhiteWindowMetalDoor = "白色带窗金属门",
WhiteMetalDoor = "白色金属门",
BlueMetalDoor = "蓝色金属门",
DoubleMetalBlackGlassRightDoor = "黑色玻璃双开金属右门",
BlackMetalDoor = "黑色金属门",
PizzaWhirledGreenMetalDoor = "Pizza Whirled（披萨店品牌）绿色金属门",
DoubleMetalBlackGlassLeftDoor = "黑色玻璃双开金属左门",
DoubleMetalGreyRightDoor = "灰色双开金属右门",
PileOCrepeOrangeMetalDoor = "Pile O' Crepe（店铺品牌）橙色金属门",
SecurityDoor = "安全门",
SpiffosRedMetalDoor = "Spiffo's（品牌）红色金属门",
DoubleMetalOrangeKitchenGlassRightDoor = "橙色厨房玻璃双开金属右门",
RedMetalDoor = "红色金属门",
DoubleMetalOrangeKitchenGlassLeftDoor = "橙色厨房玻璃双开金属左门",
BeigeAsphaltFloor = "米色沥青地板",
MediumAsphaltEdgeFloor = "中色沥青边缘地板",
LightAsphaltCornerFloor = "浅色沥青转角地板",
DarkAsphaltCornerFloor = "深色沥青转角地板",
OldAsphaltCornerFloor = "旧款沥青转角地板",
DarkAsphaltFloor = "深色沥青地板",
MediumAsphaltCornerFloor = "中色沥青转角地板",
LightAsphaltFloor = "浅色沥青地板",
BeigeAsphaltCornerFloor = "米色沥青转角地板",
OldAsphaltFloor = "旧款沥青地板",
DarkAsphaltEdgeFloor = "深色沥青边缘地板",
MediumAsphaltFloor = "中色沥青地板",
LightAsphaltEdgeFloor = "浅色沥青边缘地板",
OldAsphaltEdgeFloor = "旧款沥青边缘地板",
MiniFridge = "迷你冰箱",
RedFridge = "红色冰箱",
TrailerFridgeA = "拖车嵌入式冰箱1号",
TrailerFridgeB = "拖车嵌入式冰箱2号",
PlainFridge = "简易冰箱",
WhiteFridge = "白色冰箱",
GreenFridge = "绿色冰箱",
PopsicleFridge = "冰棒专用冰箱",
BlueFridge = "蓝色冰箱",
WhiteIndustrialFridge = "白色工业级冰箱",
IndustrialFridge = "工业级冰箱",
SteelFridge = "钢制冰箱",
GenericCooledShelves = "通用冷藏货架",
LargeFridge = "大型冰箱",
GravelEdgeFloor = "碎石边缘地板",
GravelCornerFloor = "碎石转角地板",
FadedGrassFloor = "枯萎草地",
AutumGrassFloor = "秋日草地",
BeigeGravelFloor = "米色碎石地板",
BeigeGravelCornerFloor = "米色碎石转角地板",
BeigeGravelEdgeFloor = "米色碎石边缘地板",
VerdantGrassFloor = "翠绿草地",
LowWoodenWhiteRailingPost = "白色木质矮栏杆立柱",
LowWoodenWhiteRailingTallPost = "白色木质矮栏杆高立柱",
LowWoodenRailingPost = "木质矮栏杆立柱",
LowWoodenGreyFenceCorner = "灰色木质矮围栏转角",
LowWoodenRailingTallPost = "木质矮栏杆高立柱",
LowWoodenRailing = "木质矮栏杆",
LowWoodenWhiteRailingCornerTallPost = "白色木质矮栏杆带高立柱转角",
LowWoodenWhitePicketFence = "白色尖桩木质矮围栏",
LowWoodenRailingCorner = "木质矮栏杆转角",
LowWoodenWhitePicketFenceCorner = "白色尖桩木质矮围栏转角",
LowWoodenGreyFence = "灰色木质矮围栏",
LowWoodenGreyFencePost = "灰色木质矮围栏立柱",
LowWoodenRailingCornerTallPost = "木质矮栏杆带高立柱转角",
HescoBarrier = "防爆土堤（Hesco 为防爆设施品牌）",
WroughtIronLowFenceCorner = "锻铁矮围栏转角",
WroughtIronLowFencePost = "锻铁矮围栏立柱",
WroughtIronLowFence = "锻铁矮围栏",
LowWoodenWhiteRailing = "白色木质矮栏杆",
LowWoodenWhitePicketFencePost = "白色尖桩木质矮围栏立柱",
LowWoodenWhiteRailingCorner = "白色木质矮栏杆转角",
HangingToilet = "壁挂式马桶",
FancyToilet = "精致马桶",
ChromeSink = "镀铬水槽",
BeigeSink = "米色水槽",
LowToilet = "矮款马桶",
IndustrialSink = "工业级水槽",
WhiteStandingSink = "白色落地式水槽",
WhiteHangingSink = "白色壁挂式水槽",
DeluxeShower = "豪华淋浴间",
DarkIndustrialSink = "深色工业级水槽",
WhiteSink = "白色水槽",
LargeDeluxeBath = "豪华大浴缸",
CarLiftPillar = "汽车举升机立柱",
CarLiftUpperMiddlePart = "汽车举升机上中部组件",
CarLiftLowerPart = "汽车举升机下部组件",
CarLiftMiddleMiddlePart = "汽车举升机中中部组件",
FancyOrangeRugCorner = "精致橙色地毯转角",
BordeauxSideRug = "波尔多红侧边地毯",
BathroomBrownRug = "浴室棕色地毯",
DarkGreySideRug = "深灰色侧边地毯",
FancyBrownRug = "精致棕色地毯",
DarkGreenRugCorner = "深绿色地毯转角",
DarkGreyRug = "深灰色地毯",
DarkGreenRug = "深绿色地毯",
DarkGreenSideRug = "深绿色侧边地毯",
BathroomPurpleRug = "浴室紫色地毯",
BordeauxRug = "波尔多红地毯",
BordeauxVictorian2Rug = "波尔多红维多利亚风格2号地毯",
FancyBlueRug = "精致蓝色地毯",
DarkPurpleVictorian1Rug = "深紫色维多利亚风格1号地毯",
DoorMat = "门垫",
DarkGreenVictorian1Rug = "深绿色维多利亚风格1号地毯",
DarkPurpleSideRug = "深紫色侧边地毯",
DarkPurpleRug = "深紫色地毯",
DarkPurpleRugCorner = "深紫色地毯转角",
BordeauxVictorian1Rug = "波尔多红维多利亚风格1号地毯",
FancyGreenRugCorner = "精致绿色地毯转角",
BordeauxRugCorner = "波尔多红地毯转角",
FancyOrangeRug = "精致橙色地毯",
FancyBlueRugCorner = "精致蓝色地毯转角",
FancyGreenRug = "精致绿色地毯",
FancyBrownRugCorner = "精致棕色地毯转角",
DarkGreenVictorian2Rug = "深绿色维多利亚风格2号地毯",
DarkPurpleVictorian2Rug = "深紫色维多利亚风格2号地毯",
MetalBrownRailroadFloor = "棕色金属铁轨地板",
MetalRustyMeshFloor = "生锈金属网格地板",
MetalRustyMeshGrateFloor = "生锈金属网格格栅地板",
MetalGreenIndustrialFloor = "绿色金属工业地板",
MetalElevatorFloor2 = "2号金属电梯地板",
MetalElevatorFloor1 = "1号金属电梯地板",
MetalGreyRailroadPanelFloor = "灰色金属铁轨面板地板",
MetalSteelBarsFloor = "金属钢条地板",
MetalGreyIndustrialFloor = "灰色金属工业地板",
DarkBrownWoodenStairs = "深棕色木质楼梯",
YellowBrownWoodenStairs = "黄棕色木质楼梯",
WhiteIndustrialWoodenStairs = "白色工业风木质楼梯",
SimpleWoodenStairs = "简易木质楼梯",
WhiteMotelWoodenStairs = "白色汽车旅馆木质楼梯",
BrownWoodenStairs = "棕色木质楼梯",
MedicalMetalCounter = "医疗用金属柜台",
MilitaryLocker = "军用储物柜",
LargeMetalShelves = "大型金属货架",
SmallClothesRack = "小型衣帽架",
StandingVault = "立式保险柜",
BlueWallLocker = "蓝色壁挂式储物柜",
YellowWallLocker = "黄色壁挂式储物柜",
ClothesStand = "衣物架",
GreyFileCabinet = "灰色文件柜",
WallBin = "壁挂式垃圾桶",
WallVault = "壁挂式保险柜",
WhiteFileCabinet = "白色文件柜",
LargeClothesRack = "大型衣帽架",
WhiteMicrowave = "白色微波炉",
GreenOven = "绿色烤箱",
JorgeForeguyBarbecue = "Jorge Foreguy牌烧烤架",
GreyOven = "灰色烤箱",
ChromeMicrowave = "镀铬微波炉",
Barbecue = "烧烤架",
IndustrialOven = "工业级烤箱",
FryersClubIndustrial = "Fryers Club工业级2000型炸炉",
RedOven = "红色烤箱",
AntiqueOven = "复古烤箱",
ModernOven = "现代风格烤箱",
ConcreteFloor = "混凝土地板",
ConcreteCornerFloor = "混凝土转角地板",
GreySmoothTilesFloor = "灰色光滑瓷砖地板",
WhiteSmoothTilesFloor = "白色光滑瓷砖地板",
BeigeSmoothTilesFloor = "米色光滑瓷砖地板",
DarkGreySmoothTilesFloor = "深灰色光滑瓷砖地板",
CeramicFloorBlackTiles = "黑色陶瓷地板砖",
CeramicFloorWhiteDiagonalTiles = "白色斜纹陶瓷地板砖",
CeramicFloorYellowCheckeredTiles = "黄色格子陶瓷地板砖",
CeramicFloorGreyTiles = "灰色陶瓷地板砖",
CeramicFloorBrownCheckeredTiles = "棕色格子陶瓷地板砖",
CeramicFloorBrownTiles = "棕色陶瓷地板砖",
CeramicFloorGreyDiagonalTiles = "灰色斜纹陶瓷地板砖",
CeramicFloorDarkGreyTiles = "深灰色陶瓷地板砖",
CeramicFloorBlueCheckeredTiles = "蓝色格子陶瓷地板砖",
CeramicFloorDarkGreySquaresTiles = "深灰色方块陶瓷地板砖",
CeramicFloorGreenTiles = "绿色陶瓷地板砖",
CeramicFloorCinnamonTiles = "肉桂色陶瓷地板砖",
CeramicFloorBeigeCheckeredTiles = "米色格子陶瓷地板砖",
CeramicFloorBlackDiagonalTiles = "黑色斜纹陶瓷地板砖",
CeramicFloorPurpleTiles = "紫色陶瓷地板砖",
CeramicFloorGreenDiagonalTiles = "绿色斜纹陶瓷地板砖",
CeramicFloorGreyCheckeredTiles = "灰色格子陶瓷地板砖",
CeramicFloorWhiteCheckeredTiles = "白色格子陶瓷地板砖",
CeramicFloorGreySquaresTiles = "灰色方块陶瓷地板砖",
CeramicFloorHardwoodTiles = "硬木纹理陶瓷地板砖",
CeramicFloorBirchwoodTiles = "桦木纹理陶瓷地板砖",
CeramicFloorBrownDiagonalTiles = "棕色斜纹陶瓷地板砖",
CeramicFloorYellowDiagonalTiles = "黄色斜纹陶瓷地板砖",
CeramicFloorAcaciaTiles = "金合欢木纹理陶瓷地板砖",
WiredHighFenceCorner = "带铁丝网高围栏转角",
WiredRazorHighFenceCorner = "带刀片铁丝网高围栏转角",
WroughtIronHighFence = "锻铁高围栏",
WiredHighFence = "带铁丝网高围栏",
WoodenDecorativeHighFencePost = "木质装饰性高围栏立柱",
WroughtIronHighFenceCorner = "锻铁高围栏转角",
ChainlinkAndRazorWireHighFence = "链式铁丝网带刀片高围栏",
WoodenHighFenceCorner = "木质高围栏转角",
WoodenHighFencePost = "木质高围栏立柱",
WroughtIronHighFencePost = "锻铁高围栏立柱",
ChainlinkAndRazorWireHighFenceCorner = "链式铁丝网带刀片高围栏转角",
WiredRazorHighFence = "带刀片铁丝网高围栏",
ChainlinkAndRazorWireHighFencePost = "链式铁丝网带刀片高围栏立柱",
WoodenDecorativeHighFence = "木质装饰性高围栏",
WoodenHighFence = "木质高围栏",
SmallWoodenCrate = "小型木质木箱",
VegetableBasket = "蔬菜篮",
GreyMilitaryCrate = "灰色军用木箱",
BatteredCardboardBox = "破旧纸箱",
GreenMilitaryCrate = "绿色军用木箱",
BigCardboardBox = "大型纸箱",
WhiteWashingMachine = "白色洗衣机",
BlueComboWasherDryer = "蓝色洗烘一体机",
WashingBin = "洗衣桶",
WhiteClothingDryer = "白色烘干机",
BigWallShelves = "大型墙面货架",
WhiteFancyShelves = "白色精致货架",
BigWallShelvesCorner = "大型墙面货架转角",
HospitalBed = "病床",
TwinBed = "单人床",
StretcherBed = "担架床",
FancyBed = "精致床",
SimpleBed = "简易床",
BunkBed = "上下铺床",
LargeFancyBed = "大型精致床",
LargeOakBed = "大型橡木床",
LargeModernBed = "大型现代风格床",
BlueBed = "蓝色床",
Trailer2Window = "2号拖车窗户",
TiledWindow = "瓷砖边框窗户",
SliderWindow = "推拉窗",
ChromeWindow = "镀铬边框窗户",
ArchedWhiteWoodenWindow = "白色木质拱形窗户",
Trailer1Window = "1号拖车窗户",
WhiteTiledWindow = "白色瓷砖边框窗户",
WhiteWindow = "白色窗户",
WoodFloorWidePlank = "宽木板地板",
WoodFloorCinnamon = "肉桂木纹理地板",
WoodFloorPinewood = "松木纹理地板",
WoodFloorFinewood = "细木纹理地板",
WoodFloorOakwood = "橡木纹理地板",
WoodFloorChestnut = "栗木纹理地板",
WoodFloorHardwood = "硬木纹理地板",
WoodFloorBirchwood = "桦木纹理地板",
MailBox = "私人邮箱",
PublicMailBox = "公共邮箱",
RoadConeBig = "大型路锥",
PostBarrier = "立柱式路障",
ConcreteRoadBlock = "混凝土路障",
Standpipe = "竖管（供水/供油）",
ConcreteWheelStop = "混凝土车轮挡块",
RoadBlock = "路障",
RoadConeSmall = "小型路锥",
GreyGarbageBin = "灰色垃圾桶",
SpiffosBin = "Spiffo's（品牌）垃圾桶",
FossoilGarbageBin = "Fossoil（品牌）垃圾桶",
GreenGarbageBin = "绿色垃圾桶",
WheelieBin = "带轮垃圾桶",
PublicGarbageBin = "公共垃圾桶",
BlueDumpster = "蓝色大型垃圾桶",
MallGarbageBin = "商场垃圾桶",
OrangeDumpster = "橙色大型垃圾桶",
RoundBin = "圆形垃圾桶",
RecycleBin = "回收垃圾桶",
BirchwoodCounterCorner = "桦木柜台转角",
BirchwoodCounter = "桦木柜台",
MotelCounterCorner = "汽车旅馆矮柜台转角",
WhiteCounter = "白色柜台",
WhiteCounterCorner = "白色柜台转角",
DarkCounterCorner = "深色柜台转角",
WoodenCounter = "木质柜台",
TrailerCounter = "拖车柜台",
GreenCounter = "绿色柜台",
GreenCounterCorner = "绿色柜台转角",
WoodenCounterCorner = "木质柜台转角",
ModernCounter = "现代风格柜台",
OakCounter = "橡木柜台",
BirchwoodFloatingCounter = "桦木悬浮式柜台",
OakCounterCorner = "橡木柜台转角",
MotelCounter = "汽车旅馆柜台",
ModernCounterCorner = "现代风格柜台转角",
TrailerFloatingCounter = "拖车悬浮式柜台",
DarkCounter = "深色柜台",
DogHouse = "狗窝",
MakeshiftTarget = "简易制作的靶标",
ElevatorStairs = "电梯配套楼梯",
ModernStairs = "现代风格楼梯",
BrownMetalStairs = "棕色金属楼梯"
CeramicFloorRedCheckeredTiles = "陶瓷地面红格瓷砖"
CeramicFloorWhiteBlackTiles = "陶瓷地面黑白瓷砖"
CeramicTurquoiseTiles = "青绿色光面瓷砖地面",
Sandbox_BuildablesExpansion = "建筑扩展",
Sandbox_UnlockingMethod = "建筑解锁方式",
Sandbox_UnlockingMethod_tooltip = "控制建筑配方的学习方式及其在建造菜单中的显示。<BR>可选择通过阅读杂志、绘制速写本，或两种方式结合。",
Sandbox_BuildablesExpansion_unlockingMethod_option1 = "两者结合：学习或绘制",
Sandbox_BuildablesExpansion_unlockingMethod_option2 = "仅通过杂志",
Sandbox_BuildablesExpansion_unlockingMethod_option3 = "仅通过速写本",
Tooltip_SketchBook_AlreadySketched = "已在本建筑师速写本中绘制",
Tooltip_SketchBook_CanSketch = "可绘制",
Tooltip_SketchBook_CannotSketch = "不可绘制",
Tooltip_SketchBook_SketchStatus = "绘制状态：",
Tooltip_craft_pavedFloorDesc = "当你厌倦了被亡灵绊倒时，<br>或许需要更坚固的地面",
Tooltip_craft_concreteFloorDesc = "地面坚硬如你求生的意志，<br>比你的生命更持久",
Tooltip_craft_woodFloorDesc = "即便是亡灵，也值得在<br>漂亮的木地板上蹒跚",
Tooltip_craft_carpetFloorDesc = "柔软到能暂时掩盖尖叫的声音，<br>至少能撑一会儿",
Tooltip_craft_commercialCounterDesc = "带储物空间的木质柜台，<br>适合搜刮物资或制作物品时使用",
Tooltip_craft_commercialCounterNoCraftDesc = "坚固的储物柜台，<br>不会像你最后的希望那样让你失望",
Tooltip_craft_floatingCounterDesc = "壁挂式柜台节省空间，<br>毕竟你总是缺这点地方",
Tooltip_craft_cardboardCrateDesc = "简易纸箱，<br>或许和你的生存一样转瞬即逝",
Tooltip_craft_militaryCrateDesc = "坚固的箱子，足以装下你的希望与梦想……<br>或者弹药之类的东西",
Tooltip_craft_vegetableBasketDesc = "装新鲜蔬果的篮子……<br>前提是你能活到享用它们的那天",
Tooltip_craft_metalLockerDesc = "金属储物柜，保护你的装备安全——<br>或者只是用来锁起你的绝望",
Tooltip_craft_metalClothesStandDesc = "挂衣服的架子……<br>毕竟在丧尸群中奔跑也是一种时尚宣言",
Tooltip_craft_metalContainerDesc = "坚固的容器，存放你的贵重物品……<br>如果你还剩下些什么的话",
Tooltip_craft_trashCanDesc = "装垃圾的容器……<br>包括你所有失败的生存尝试",
Tooltip_craft_sinksDesc = "洗手池，洗去世间污秽……<br>前提是还有水能用",
Tooltip_craft_showerDesc = "淋浴器，让你回忆起<br>最后一次感觉干净的时刻",
Tooltip_craft_toiletDesc = "因为即便是末日，<br>也总得解决人生大事",
Tooltip_craft_windowsDesc = "窗户，用来观望世界燃烧……<br>保持安全距离的那种",
Tooltip_craft_microwaveOvenDesc = "微波炉，快速加热食物用，<br>谁还有时间正经做饭呢？",
Tooltip_craft_electricOvenDesc = "烤箱，用来烘焙你最后的希望……<br>前提是还有电",
Tooltip_craft_barbecueDesc = "烧烤架，用来烤肉……<br>反正亡灵也不挑",
Tooltip_craft_fridgeDesc = "冷藏食物，或者储存你对<br>美好明天的幻想",
Tooltip_craft_laundryMachinesDesc = "洗衣机和烘干机……<br>如果你还抱有一丝乐观的话",
Tooltip_craft_washingBinDesc = "装脏衣服的桶……<br>或许是因为你累到懒得洗了",
Tooltip_craft_bookshelvesDesc = "书架，用来放书……<br>知识总还是重要的吧？",
Tooltip_craft_garageDecorationsDesc = "车库装饰品……<br>当你需要藏在显眼处时用",
Tooltip_craft_roadwayDecorationsDesc = "道路装饰……<br>或者说，只是更多的死亡陷阱",
Tooltip_craft_outdoorDecorationsDesc = "花园装饰品。",
Tooltip_craft_rugsDesc = "地毯，增添舒适感，<br>或掩盖世界末日的恶臭",
Tooltip_craft_bigWroughtFenceDesc = "大型铁围栏，挡住生者或死者——<br>其实也没什么区别",
Tooltip_craft_armchairDesc = "舒适的扶手椅，<br>当你累到跑不动的时候",
Tooltip_craft_chairsDesc = "椅子，用来坐……<br>如果你有幸能停下来的话",
Tooltip_craft_couchesDesc = "沙发，用来躺……<br>或者躲起来避开尸群",
Tooltip_craft_dressersDesc = "抽屉柜，存放你再也不会穿的衣服",
Tooltip_craft_fireplaceDesc = "壁炉，提供温暖……<br>或舒适地看着世界燃烧",
Tooltip_craft_lightSwitchDesc = "电灯开关……<br>前提是还能亮",
Tooltip_craft_lampDesc = "台灯，照亮你<br>不可避免的末日",
Tooltip_craft_lightPostDesc = "柱式路灯，吸引更多丧尸。<br>还能出什么岔子呢？",
UI_CraftCat_Lighting = "灯",
UI_CraftCat_Windows = "窗户",
UI_CraftCat_Appliances_Bathroom = "卫浴设备",
UI_CraftCat_Appliances_Cooking = "烹饪设备",
UI_CraftCat_Appliances_Fridges = "冰箱",
UI_CraftCat_Appliances_Laundry = " 洗衣设备",
UI_CraftCat_Containers_Bookshelves = "书架",
UI_CraftCat_Containers_Commercial = "商用容器",
UI_CraftCat_Containers_Crates = "木箱",
UI_CraftCat_Containers_Metal = "金属容器",
UI_CraftCat_Containers_Residential = "家用容器",
UI_CraftCat_Containers_Trashcans = "垃圾桶",
UI_CraftCat_Decorations_Garage = "车库装饰",
UI_CraftCat_Decorations_Outdoor = "户外",
UI_CraftCat_Decorations_Roadway = "道路装饰",
UI_CraftCat_Decorations_Rugs = "地毯",
UI_CraftCat_Doors_Garage = "车库门",
UI_CraftCat_Doors_Metal = "金属门",
UI_CraftCat_Doors_Wooden = "木门",
UI_CraftCat_Fences_High = "高围栏",
UI_CraftCat_Fences_Low = "矮围栏",
UI_CraftCat_Floors_Carpets = "地毯",
UI_CraftCat_Floors_Ceramic = "陶瓷地板",
UI_CraftCat_Floors_Concrete = "混凝土地板",
UI_CraftCat_Floors_Metal = " 金属地板",
UI_CraftCat_Floors_Natural = "天然材质地板",
UI_CraftCat_Floors_Paved = "铺装地面地板",
UI_CraftCat_Floors_Wooden = "木质地板",
UI_CraftCat_Furniture_Beds = "床具",
UI_CraftCat_Furniture_Dressers = "抽屉柜",
UI_CraftCat_Furniture_Seating = "座椅",
UI_CraftCat_Furniture_Tables = "桌椅",
UI_CraftCat_Stairs_Metal = "金属楼梯",
UI_CraftCat_Stairs_wood = "木质楼梯"
Recipe_ = "",
Tooltip_craft_metalDoorDesc = "",
Tooltip_craft_woodenCrateDesc = "一个基础的木制储物箱——非常适合<br>存放那些你永远不会用的东西",
