DisplayName_Axe_Handle	= "Axe handle",
DisplayName_Fire_Axe_Head	= "Fire axe blade",
DisplayName_Hand_Axe_Head	= "Hand axe blade",
DisplayName_Metal_Axe_Handle	= "Metal axe handle",
DisplayName_Wood_Axe_Head	= "Axe blade",
ItemName_Base.AxeHandle = "Axe Handle",
ItemName_Base.FireAxeHead = "Fire Axe Head",
ItemName_Base.HandAxeHead = "Hand Axe Head",
ItemName_Base.MetalAxeHandle = "Metal Axe Handle",
ItemName_Base.WoodAxeHead = "Wood Axe Head",
Recipe_Craft_Axe_Handle	=	"Create an axe handle",
Recipe_Craft_Axe_Handle2	=	"Create an axe handle",
Recipe_Craft_Fire_Axe	=	"Create fire axe",
Recipe_Craft_Hand_Axe	=	"Craft a hand axe",
Recipe_Craft_Metal_Axe_Handle	=	"Craft a metal axe handle",
Recipe_Craft_Wood_Axe	=	"Create axe",
Recipe_Destroy_Stone_Axe	=	"Destroy stone axe",
Recipe_Remove_Axe_Head	=	"Saw off the axe blade",
Recipe_Remove_Axe_Head2	=	"Saw off the axe blade",
Recipe_Remove_Axe_Head3	=	"Saw off the axe blade",